##########################################
#      *  *  O     >*      @          =*O#
#      ** O OO     >*        S        =**#
#:::::#########::::#::##############::=X*#
#     !!!!         ##     *+!        ===A#
# S  +: +  +    #O  #!!!!!!!!          TM#
#:=::::::  :    >*> #   *  *  *         =#
#::::=:::  =    # O #   *  *            *#
#:=::::::  : +   ####   ****  *   !!!!! =#
#::::*:::  =        #   *  *  *  : O O : #
#:+::::::: : : +    #   *  *  * *!  !  !*#
#::::=:::  = : :    #:::::::::::  \***/  #
#::::::::  : :    +                ===   #
#::::=:::  = : #: = *##########::::::::*:#
#>*::::::  : : :  : *                    #
#::::=: =  = ^ =  = * ##  +::::::::::*** #
#::::S: S  S S S  S * *#       !     ::S #
##########################################
