##########################################
#:::     !!!        !=#=#=#=#=#=#=#=#!^O #
#::=    /   \       !#=#=#=#=#=#=#=#=!\:<#
#=:<    *   *       \================/   #
#*^                         * ** *       #
#=       =:=         *>\    ^\<>/     */X#
#     =\ ^ ^ /=      \<*    ^ \/      /!!#
#     O= S S =O             ^M/         *#
#   +<<<     >>>+          \*/     O /!!!#
#    =    !    =            \    /*!::<<!#
#        :^:                 #<    \!:!!!#
#        ^ ^                !*>: \   ^*!*#
#   *   >>:<<   *  \        ^^*:*    >\! #
# O                 \         ^^^  T<<O A#
#====/         \====#\        ^*^  ^^!^! #
#*>\/     @  *  \/<*!>\       ^^^    !^!*#
# ^   /=\ *</=\   ^ !>>*           /*!*!^#
##########################################
