##########################################
#MOM >>>\!*!   \   S   / */<<#O#O#O ****##
#              O   !   O     #: : : \OOO##
## #     # O####*#######                 #
#>>>>/   O >     :        /###:::\###### #
## #*#<<<### ##### /#######   OOO#   O   #
# *\     *#* # >   #        + *      ### #
# #O\######  # /##*#S###O##   /OO##\ *#  #
#      *O  O # #T*# * #>O+*#####/ *# #* /#
###### ### #*# #*!#M  ## \OOO/*\  #O ## *#
#  *+**   *### # O###O/ A            #+# #
#  \###\M#   # #TO#O :  #/OOO\ /######   #
#       \# #O# # :  @##*#####/ \#S *+  O #
# +     #/   : \#### ###/     < # # #:#:##
# + # O #    #     \#/    /#### #S#+  #S##
# +   #<#  O \###\   S /##      ##### # ##
#S S S  *    *****##X##***>>>>      * *  #
##########################################
