##########################################
#OOOOOOOOOOOOOOOOOOO# X                  #
#:*:::::::::::::::::#O O                 #
# ^^^^^^^^^^^^^^^^::#         /*\        #
# ################  #        /^^^\       #
#     *O*+*         #       /^^*^^\      #
# ################  #   :::::#####:::::::#
#>        S           #                  #
#**                ###               #::<#
#####:::#::::::::::<#                #::<#
#O*O*::#O############>*              #::<#
#>>*O:## ##                          #::<#
#O>***#* *#                       :  #::<#
#***###* *#::::::::::::::::::::::::::::::#
####O  # #@#       :   :    : :<<<<<<##**#
#>                                     ::#
#** *  ###::::::::::::^::::::::::::::::^^#
##########################################
