##########################################
#            \O******O/          *:*:*#*O#
#  *  O       \OO**OO/     *O*O*      O O#
#  O  *O*      \OOOO/               >  OO#
#  *  O         \OO/         >  >      :O#
#  O  *        /:O/   *O<            ## *#
#OO*          #* /    >O*             ## #
#\             \       *<       >>*      #
##\    \                               ###
##X\O O \                                #
#*OO       *<    O           O:O*O:O<<   #
# >              OO          *<<<<<      #
#::::**O \       OO      # ============= #
########  \      ::      #O<>*::*>::**:*O#
#*O*O*O*O* \             #O>>:**>OO@ M*OO#
#O O O O  ::::*==    A   #O*:#O O::*#O<:*#
#: * * *O*:::==*     *<< #*>:====::*: **T#
##########################################
