##########################################
#\>O\OOOOOOOOOO/         /   *     =====##
#*\*::*::::::*/          \>OOOO<O/   ===##
#  \  \      /            \O XOO/     ==##
#   \  \    /     O        \OOO/>     O==#
#    \  \  /             < /OO/ *     :*=#
#     \  \/               /OO/     #######
#     /          >:    /   :*         ####
#  *>:   /\ O    !@!       \            ##
#   /   /==\                \            #
#  /   /==* \      ==================== !#
# /   /==*   \     >O O O O O O O O O O<!#
#/   /==* !   \     >O O O O O O O O O <*#
# :</==*    >                A *        ##
#>*/==* !                               ##
# /==*     *   *<\*<   #=#=#=>  \#=#=\ <##
#*==* !    !      ::\        *T         ##
##########################################
