##########################################
##########################################
##X   #   /OO\  /  O<OOOOO   \OOOOOOO#OT##
## ##O#/          OOOOOO/     OOOOOO #O<##
##O# **    /    #* A          \OOOO *#* ##
## # #  /  O\  OO#\    \   \   \OO/**# ###
## #:O     <>  */*#\        \*OOO<* <#  ##
##   O    /\  / #*O*\ /\     @ \  * < /<##
##  OOO## ##\*# #*O*# # \ <  >      \#  ##
####\ *       #*#*O #  >>             O ##
##    O#      # # # # #\             /* ##
## ##     #   # #*##  ##\     :*<<<<<   ##
## OO  /# #   # #*#   ###      /    \   ##
## \O\OO# #   # #*#  ####/           \  ##
## #O#*:#>:\  # #    *##/  ##\       #\ ##
##  O#* # :*\   ####*/       * \   / : *##
##*****:# *:* /        #      O ***#*#  ##
##########################################
