##########################################
#==/*<</O       #OM# >OO     O  /      =*#
#+      :\      :<## *OO     :         O<#
#/     *:             ::           /==*OO#
#      ===          ===\     /  + /*  :OO#
#       *       +  =S S=    /  /  \===:###
#       \ /       *S   =      /     *=:###
#       =*=  *   *@*=== O   *       =::<##
#        = ::==   *     :   O         \<##
#  /:<<:       =  ====     =+=    \     ##
#    :<<:       ===*  :::::   \       O:<#
# */  :<<:                     \      *:*#
#               ::              *       !#
#**=      :::::::::       /  !        \  #
#S *       :   ::+:  /##>T   X##       \*#
#  *   =   :   :::: /##*#######A *      \#
#  *   S       ::*:/#          *<<<<<<<<<#
##########################################
