##########################################
#T*# C #  OOX######*####O ################
#*!#M  #< ::#####\OOO/#         #  :  O  #
# O###O# A    ####\O/## ## ###\T<:::::O ##
#TO#O :  #  #          C  #OOO# #  :  O ##
# :  @##*#<<###:#########  ***  #  :  O *#
##### ##/   #O*#O*O    S#########  :  O ##
# O+#/OO  /*#>T : : # +         >: :  : ##
#  :  O/   *# #OO####   ##################
#  #  >O  ###  ::   C####                #
#  #   O   *#\ ## O<<T* * O              #
#\ # # ######**##<## #S#################*#
#  #  #O   *#     S# # #                 #
# ##\  :   *## ##### ###  O O O O OO  OOO#
#    O: #>>>#S*      # #  OOO O O O O O O#
# #S \  O   # ########S#  O O OOO OOO OOO#
#   ## #### ###C++++C *                  #
##########################################
