##########################################
#****!**/                    O   O< *  M##
#O***!*/              O<O*O*O       *   ##
#*O**!                *     *<      O<<*##
#O*O*        *!*!* * /              >  *##
# O /       >> > >  /                  *##
#O /               O        @   ::::====##
# /  <*<                            *  S##
#/       \             <         /  *   ##
#*  >     \         \     /     /   *   ##
#* >                  ===           ====##
# >                        *         ***##
#>    <=========   >   \   +   /==== :==##
#=    <=*O*>>>>     +     /          :::##
#     <=****===    \     /     /:   *<<<##
# ======*=**=:::    \         /:::  *   ##
#::X*::::  <=::::            /::::: *S  ##
##########################################
