##########################################
#O*OO+!*\O*        :      *</>CCOO:O ::^O#
#* *</   >:\>   :  ^S O   </OOOOO^::</::<#
#\        ^O  +     : :   /OOOOO< ::/::::#
#!<::: :+:::      :     </>OOOO<  :/:: ::#
#>:\O: S ::\>   :    OOO!:::^+^ :</ ^!::\#
#   \* >: O \>       OOO/       :/   \^^^#
# :  \    :  !========^^     <  /     :^^#
# :   \       O   OO  O \      /*    \<^^#
#A:M! X/      :       :     :  \^  :  \*^#
#     /   :>O====\  /===\  S^   \    * \T#
# />:/     >/>>        <<\!   *  \S  ^  \#
#O**/   :*<    :::>>\!:    !  ^  O\    * #
#O*/    ==/O+    ***     +O \O\  :O\   ^ #
# = O  /O/ ^    *<S>*     ^ O*!\  @ \/T!!#
# /***/ ::=     *<:>*      *<OO>\::::\^O #
# ^^^!>*C:: \   *<S>*  : /   ::      *\*<#
##########################################
