##########################################
#C      O  OOO ##       \OOO*OOOO/    O *#
#       *       *#       \OOOOOO/ >     A#
##!        /    #         \OOOO/         #
#  O    /         O      *<\OO/  =*==\   #
#\O<   /          :        :O/!!!    O\*/#
#>O   /                     /        :=  #
##O\ /                              = *  #
##O          /   @         \         ====#
##O         /    O    *<    \            #
#**              :            /          #
#====/                       /           #
#       \                   /            #
#X!   \ *\                 /             #
#!    /!!!*/!!!!!/*<      /   *          #
#>*   \!!!/         !!\    /             #
#*      *             *\ */T            *#
##########################################
