##########################################
#!\ !  /\      *            >>OOOO*OOOOOM#
#! \! !XA!                  >>>OOOOOOOOOO#
#!  !  \/                   >>>>OOOOOOOO<#
#        O                  >>>>>OOOOOO<<#
#!= /== /= /=\ !=\ !=  *    >>>>>OOOOO<<*#
#!  !   !  ! ! ! ! !   *    >>>>//OOO<<<<#
#!= \=\ !  !=! !=/ !=  *          OO<<<<<#
#!    ! !  ! ! !   !              :<<<<<<#
#!= ==/ \= ! ! !   !=  *          *O<<<<<#
#                                  :O<<<<#
# *   # #  #     # #  #   !         :\<<<#
#     # # # #    # # # #  !    \      \<<#
#     ### ###    ### ###  !     \      \<#
#     # # # #    # # # #         \       #
#     # # # #    # # # #  !              #
#T                 @                    *#
##########################################
