##########################################
#     >O=     O\S:::*=O*:O**OS::O ##   #O#
# =>   :=   !S  \==>:       *==== #  ! ! #
# =  *  = +      >:! ==O=* !:   ^  * ! ! #
#>OO:   =  T*  #    !O*O*# ##\     :C#   #
#: ::* :      \## >     /# #O #< :T: #####
#:OOO\*>OOOO/ :# S >     \    /    : :   #
#:: ::<>\OO/=\^#O! ^ >/>< ===/   :O\+<   #
#::OO:::: ::X \#O :: !>>>*::   / *+/  :/##
#*\* O*^^^^:\SC**M \:+\/OO\  ++   /+  !<+#
#*S>\>C:::: /=======  OO+++\   S/+#  /!O:#
#S *S\OOO*          O ::    \**/     :::*#
#SSSS \O===== >   /*O\*<@           /^^ O#
#*****/:    !  O  /^^=*/O:*<<<O<+ ! !OOOC#
#    /    \       *!S : \O:<<\  OO   : : #
#>>>>C+    \  / /      *<^^<^<\>OOOO!!\: #
#^^^>::*:O:*\*#*##   O   C**</*:::::  >*A#
##########################################
