##########################################
#           \OOO*O*OOO/                  #
#            \OOOOOOO/                   #
#             \OOOOO/                   /#
#\             \OOO/                   /<#
#>\             \O/                   /<<#
#>>\           =   =                 /<<<#
#>>>\==========X   ===============  /<<<<#
#*>>>\                             /<<<<*#
#>>>>>>         @                  <<<<<<#
#*>>>/                             \<<<<*#
#>>>/============       ============\<<<<#
#>>/            =  /^\  =            \<<<#
#>/             = /^^^\ =             \<<#
#/               /^^^^^\               \<#
#               /^^^^^^^\               \#
#              /^^^*^*^^^\               #
##########################################
