##########################################
#*OO/  *= OC*O         !***!       OO****#
#OO/   ^^ ^^^^          \O/        ^^    #
#O/   /==\      /   /\O< ^        /   O###
#O#  />OO  O/    >OO#=O=         /   <<*X#
#>O /  ^^         *<#=O=        /     =*=#
#\O/     # /\      ##=O= /     /      =O=#
#=O=     >    /\      ^   #   /       =O=#
#=O= >     \>    /\          /        =O=#
# ^           \    \        O   ^    ^^^ #
#=\ ==\               @    /   >O    // <#
#          /O          \       \O/      =#
#      \  / >O  O   \           ^       :#
#            >O      \                 \:#
# O  /\       >O      \              <<=*#
#>*:/     >:   ^              \# ## /#####
#**/* ##*###*##########*##            *:*#
##########################################
