##########################################
#*!>>O           \*OOOOO />O   \#T#X#O#O*#
#  O ::!:::::::O  \OOOOO/:#*    #   ::::<#
##>: ::::::!#>#:   \OOO/::# # # *## ###O##
#####::#>*  \:      \O/  =# # #===# ## :##
#*             \    :<#  #  ::      #O :<#
####O/###########    /#     ##! ==###: A##
##O#>>>>>>>>>: *#      >>:   #  #:::::#*##
#>*        *= O##   \    ## ## !#:######*#
##    ##### ! :<#         # !#  #    / :<#
#== =O   !>:  :=#    /   *< =# ><  O  @ ##
#O<#O:        =*          # !# =#= ======#
#*::   #!!!!!  =#   \       =#  O#     :<#
############## =#O          !#! ::==== !*#
# >:             :   / #     ##        ! #
### #         ####     #  #   =========! #
#*  #!!!!!!!!!*::::#*# # #*>:            #
##########################################
