##########################################
#                                       ##
# ##################################### ##
# O*O*O*O*#               #*#*#*#*#*#*# ##
# #O#O#O#O# ############# #OOOOOOOOOOOOO##
# OO**OO**O #           # #OOOOOOOOOOO:O##
# O#O#O#O##O# ######### # #:::::::::::::##
# **O O O O O #       # # #:::::::::::::##
# #*#*#*#*#*### # # # # #   ##############
#             # # # #   ^ # #O#O#O#O#O#O##
############# # # # #########OO*OO*OO*OO##
# OOOOOOOOOO  # # #        @#OOO*OOO*OOO##
#>*::*::::::#X# # ###########:::::::::::##
#>****::::::#   #            :::::::::::##
#>*::****<# ############### # : : : : : ##
#>*^^^^^^#                  # # # # # #M##
##########################################
##########################################
