##########################################
#    # #OOOOO    O   \*O\* \     T=   ===#
# S #^*::::::    :    \OO\          =@  M#
#    #^#\              \>O\       \  *<<<#
#   A#^#*               \>*<       ======#
#   #**O#          /         /     =XO<:*#
## #**^*T#:    \            =      ::*:*:#
##*#######                   \     ======#
#^^^^**:::                   =           #
########:#                   /         *<#
#>>*\    \                   +     *   *<#
#         \                  \           #
#>>*/      \*               :            #
####                              \      #
#>O^        \*          /*\              #
#^^^         ^   /+/    \*/       /      #
#***\S            ^   \     \        \*<<#
##########################################
