##########################################
#OO                   =                  #
#**    >*        / == =    ::::::::::::::#
#               /=  =        O * O * O   #
#*/             O<= = *       \   \   \:=#
#/              >>>*=>      /   /   /   *#
#                == = *        /   /   :=#
#:=====          =  =         /   /      #
#O=   ============ ========== === === ===#
# **<<<                 *=*   *=* *=*   *#
# ========= :::==========================#
#          *<<<===OO=====================#
#*  ====    ===                        * #
#====OO=         ====O=O=O=O=O=O=O=O=O== #
#OO==OO=      O= =* * * * * * * * * * *= #
#T@ <OO=>==== *< =O=O=O=O=O=O=O=O=O=O=O= #
#XA  ::**T**  *=                       * #
##########################################
