##########################################
#X#O#                          *        O#
#*#:       O   O  O     O O    *<<<<<<<<<#
#   #\                    :   ##         #
###A#          * \           #*          #
#  !*         >O< \           #   \      #
#   !!         *   \               \     #
#   #O#             \  <     O   != \ <  #
#    *<   >            *          *=     #
#*   *#                           = >/   #
#             O      @            #      #
#             ==     \               \<  #
# O            *##    \     >            #
#>/\           #*                     : /#
#   \*          #   == \    /         O<##
#    \<    \       = = *\  /          :O##
#*!   \<   !*!     =    M\*!*!       =::T#
##########################################
